#   ###################   # #
# ####                # # # #
# ################### # # # #
#                     # #   #
##################### # # # #
#   ##                # # # #
# # ## ### ## ######### # # #
# #    #   ##B#         # # #
###                 ##### ###
#   ## ################   # #
# # ##                  # # #
# # ################# # # # #
#   ## ################ # # #
### ##             #### # # #
### ########### ## ## # # # #
###             ##    # # # #
###### ######## ####### # # #
###### ####                 #
###                 #########
#   ####### ####### ###   # #
# ####                # #   #
###### ############ #   # # #
A                   #########
