##      B
 # ##### 
 # #####
 # #####
       #
### ## #
### ##
###A#####