###                 #########
#   ###################   # #
# ####                # # # #
# ################### # # # #
#                     # # # #
##################### # # # #
#   ##                # # # #
# # ## ### ## ######### # # #
# #    #   ##B#         # # #
###                 ##### ###
#   ###################   # #
# ####                # # # #
# ################### # # # #
# # ## ################ # # #
### ##             #### # # #
### ############## ## # # # #
###             ##    # # # #
###### ######## ####### # # #
###### ####                 #
###                 #########
#   ####### ####### ###   # #
# ####                # #   #
###### ##############   # # #
A      ######################
