#######
#   # #
#A#   #
# # # #
# #   #
# ### #
#   B #
#######
