##
#  ###
## #   #B#
## # #####
##       #
#### ### #
#
#    ##
#A####