####################################################################
#B##                                                              ##
# ## ################ # #### ###### ## # ### ### ####### ### #### ##
# #                   #      ##   # ## # # # # # #       ### #  # ##
# ######## ####### ## ######### # # ## # # # # # ####### ### # ## ##
# ## ## ## ## ## # ## ##     ## # # ## # # # # # #       ### # ## ##
# ##               ## ## # # #  # # ## ### ### # # ##### ### #    ##
#  ##################### # # ## # # ##             ######### # ## ##
##                       # # #  # # ## ##### ### ##       ## # ## ##
#  ####################### # ## # # ## #     ### ## ##### ## # ## ##
# #              #   #     # #  # # ## #####   # ## #     ## #    ##
# # ############ ### #     # ## # # ## ##### ### ## ## ##### #######
# # #          # #   #     # #  #   ##           ## ## ##          #
# # ########## # ### ####### ######### ## ## ### ## ##### ######## #
# #            # #                     ## ## # # ##    ## #      # #
# ############## ############ ###### # ## #### # ## ## ## # ###### #
                 #            ###    #              ## ## #        #
## ###### ## ### # ##########   # ## # ## ### ## # ### ## ##########
## ##     ## ### # #        ### #### # ## #   ## # #   ##          #
      ###### ### # ######## # #    # #    ###      # ########## ## #
 ####      # ### #            #### # # ## #   ## # #          # ## #
 ########### ### ################# ### ## ### ## ############      #
                                       #                      #### #
##################################################################A#
