##      B
 # ######
 # #### #
 # #### #

#### ####
#### ####
####A####